Learning order,PL* rounds,PL* MQ resets,PL* MQ input symbols,PL* EQ resets,PL* EQ input symbols,PL* total resets,PL* total input symbols,Non-adaptive rounds,Non-adaptive MQ resets,Non-adaptive MQ input symbols,Non-adaptive EQ resets,Non-adaptive EQ input symbols,Non-adaptive total resets,Non-adaptive total input symbols
[12; 9; 14; 6; 5; 13; 16; 3; 1; 15; 11; 8; 10; 2; 4; 7], 16, 729302, 5871518, 79555907, 764387125, 80285209, 770258643,22, 642412, 4804082, 82690520, 786870011, 83332932, 791674093
[7; 1; 6; 16; 15; 4; 13; 14; 8; 3; 5; 2; 12; 10; 9; 11], 18, 711010, 5323262, 76456149, 734245005, 77167159, 739568267,22, 642412, 4804082, 82690520, 786870011, 83332932, 791674093
[13; 2; 15; 1; 9; 11; 5; 12; 8; 10; 16; 6; 4; 14; 7; 3], 16, 759998, 6227490, 76889044, 737273798, 77649042, 743501288,22, 642412, 4804082, 82690520, 786870011, 83332932, 791674093
[2; 11; 4; 14; 12; 1; 15; 8; 7; 3; 6; 10; 13; 16; 5; 9], 16, 709988, 5427044, 74328858, 712048134, 75038846, 717475178,22, 642412, 4804082, 82690520, 786870011, 83332932, 791674093
[15; 10; 11; 12; 3; 5; 4; 16; 7; 2; 8; 14; 13; 1; 6; 9], 18, 810236, 6092765, 78211431, 748801425, 79021667, 754894190,22, 642412, 4804082, 82690520, 786870011, 83332932, 791674093
[1; 2; 3; 7; 8; 12; 6; 11; 14; 13; 10; 4; 5; 9; 15; 16], 16, 695138, 5459458, 75410326, 723816817, 76105464, 729276275,22, 642412, 4804082, 82690520, 786870011, 83332932, 791674093
[14; 9; 15; 10; 2; 1; 4; 8; 16; 3; 12; 11; 5; 13; 7; 6], 16, 808518, 6636647, 75459597, 723538549, 76268115, 730175196,22, 642412, 4804082, 82690520, 786870011, 83332932, 791674093
[1; 8; 14; 10; 15; 3; 9; 7; 12; 6; 11; 2; 16; 5; 13; 4], 16, 805642, 6043216, 76528692, 733343851, 77334334, 739387067,22, 642412, 4804082, 82690520, 786870011, 83332932, 791674093
[6; 15; 12; 13; 1; 10; 4; 16; 7; 2; 14; 9; 11; 5; 3; 8], 18, 738518, 5509250, 76876669, 735729448, 77615187, 741238698,22, 642412, 4804082, 82690520, 786870011, 83332932, 791674093
[5; 15; 6; 13; 9; 12; 8; 16; 4; 2; 7; 1; 14; 11; 10; 3], 16, 708972, 5362004, 76484484, 732731910, 77193456, 738093914,22, 642412, 4804082, 82690520, 786870011, 83332932, 791674093
[11; 3; 10; 5; 1; 9; 14; 2; 8; 7; 6; 13; 12; 15; 4; 16], 16, 791556, 5911354, 74625192, 714911699, 75416748, 720823053,22, 642412, 4804082, 82690520, 786870011, 83332932, 791674093
[12; 2; 14; 1; 9; 4; 10; 15; 7; 11; 8; 13; 5; 6; 16; 3], 16, 788236, 5933868, 76457605, 735128312, 77245841, 741062180,22, 642412, 4804082, 82690520, 786870011, 83332932, 791674093
[16; 14; 8; 12; 4; 2; 3; 1; 7; 9; 15; 13; 11; 6; 5; 10], 16, 736084, 5510340, 75738260, 724987852, 76474344, 730498192,22, 642412, 4804082, 82690520, 786870011, 83332932, 791674093
[8; 2; 5; 13; 15; 7; 9; 14; 1; 6; 10; 4; 12; 3; 11; 16], 16, 709334, 5414426, 75460188, 722541427, 76169522, 727955853,22, 642412, 4804082, 82690520, 786870011, 83332932, 791674093
[8; 13; 4; 14; 11; 7; 15; 1; 2; 16; 6; 3; 9; 5; 10; 12], 16, 742378, 5779092, 74517750, 713976096, 75260128, 719755188,22, 642412, 4804082, 82690520, 786870011, 83332932, 791674093
[14; 15; 16; 1; 12; 10; 4; 2; 6; 3; 9; 8; 11; 7; 5; 13], 16, 799618, 6330500, 78338895, 751749664, 79138513, 758080164,22, 642412, 4804082, 82690520, 786870011, 83332932, 791674093
[14; 12; 9; 5; 10; 3; 6; 2; 4; 11; 16; 13; 8; 7; 1; 15], 16, 812120, 6231276, 78184974, 750892256, 78997094, 757123532,22, 642412, 4804082, 82690520, 786870011, 83332932, 791674093
[4; 16; 14; 1; 9; 8; 13; 5; 15; 3; 12; 7; 2; 11; 10; 6], 16, 793922, 6077988, 77337621, 743197102, 78131543, 749275090,22, 642412, 4804082, 82690520, 786870011, 83332932, 791674093
[7; 6; 12; 16; 9; 4; 5; 1; 2; 13; 8; 10; 11; 15; 3; 14], 18, 701070, 5236334, 74893367, 717614882, 75594437, 722851216,22, 642412, 4804082, 82690520, 786870011, 83332932, 791674093
[1; 4; 3; 10; 11; 7; 6; 2; 13; 9; 5; 16; 14; 15; 12; 8], 16, 810330, 6051732, 74833885, 717965458, 75644215, 724017190,22, 642412, 4804082, 82690520, 786870011, 83332932, 791674093
[10; 9; 8; 1; 3; 13; 4; 12; 15; 14; 16; 2; 11; 5; 7; 6], 18, 818402, 6104016, 80381602, 767626266, 81200004, 773730282,22, 642412, 4804082, 82690520, 786870011, 83332932, 791674093
[7; 14; 6; 1; 3; 4; 8; 11; 9; 2; 10; 13; 5; 16; 15; 12], 18, 736754, 5530432, 76107562, 728820888, 76844316, 734351320,22, 642412, 4804082, 82690520, 786870011, 83332932, 791674093
[2; 6; 7; 8; 15; 13; 9; 12; 11; 4; 1; 14; 10; 3; 16; 5], 18, 680779, 5308072, 76996550, 737285349, 77677329, 742593421,22, 642412, 4804082, 82690520, 786870011, 83332932, 791674093
[6; 14; 9; 5; 7; 11; 2; 4; 3; 16; 12; 8; 1; 10; 13; 15], 18, 702254, 5250103, 75914921, 726665354, 76617175, 731915457,22, 642412, 4804082, 82690520, 786870011, 83332932, 791674093
[13; 14; 2; 12; 10; 4; 9; 7; 6; 5; 3; 1; 8; 11; 15; 16], 16, 804072, 6327016, 76540181, 734081581, 77344253, 740408597,22, 642412, 4804082, 82690520, 786870011, 83332932, 791674093
[2; 8; 10; 16; 9; 11; 12; 14; 1; 5; 7; 15; 4; 13; 6; 3], 18, 787861, 6243407, 76943335, 736710660, 77731196, 742954067,22, 642412, 4804082, 82690520, 786870011, 83332932, 791674093
[14; 4; 9; 11; 7; 16; 10; 15; 5; 2; 12; 3; 13; 1; 6; 8], 16, 803136, 6164146, 77295340, 741107200, 78098476, 747271346,22, 642412, 4804082, 82690520, 786870011, 83332932, 791674093
[13; 12; 15; 10; 14; 11; 16; 5; 3; 1; 2; 7; 9; 8; 6; 4], 16, 812030, 6487480, 76175687, 729583559, 76987717, 736071039,22, 642412, 4804082, 82690520, 786870011, 83332932, 791674093
[11; 13; 8; 2; 4; 5; 1; 12; 7; 9; 3; 6; 15; 10; 14; 16], 16, 705184, 5518762, 76199784, 729581308, 76904968, 735100070,22, 642412, 4804082, 82690520, 786870011, 83332932, 791674093
[3; 6; 5; 8; 14; 15; 2; 11; 13; 1; 7; 12; 16; 10; 4; 9], 18, 692899, 5783466, 76056378, 727078329, 76749277, 732861795,22, 642412, 4804082, 82690520, 786870011, 83332932, 791674093
[15; 12; 7; 2; 3; 9; 5; 16; 14; 6; 4; 13; 1; 11; 8; 10], 18, 721054, 5869328, 76079114, 727640816, 76800168, 733510144,22, 642412, 4804082, 82690520, 786870011, 83332932, 791674093
[14; 16; 1; 3; 13; 8; 9; 15; 5; 12; 6; 11; 10; 2; 7; 4], 16, 719154, 5414152, 74698234, 715210534, 75417388, 720624686,22, 642412, 4804082, 82690520, 786870011, 83332932, 791674093
[14; 13; 12; 2; 16; 9; 7; 11; 10; 8; 6; 4; 15; 5; 1; 3], 16, 773284, 6058116, 77161741, 740548647, 77935025, 746606763,22, 642412, 4804082, 82690520, 786870011, 83332932, 791674093
[8; 4; 11; 16; 3; 13; 2; 15; 9; 12; 1; 10; 14; 6; 7; 5], 16, 771746, 5800948, 78232764, 751352222, 79004510, 757153170,22, 642412, 4804082, 82690520, 786870011, 83332932, 791674093
[1; 4; 2; 7; 10; 3; 16; 14; 13; 11; 9; 5; 8; 15; 6; 12], 16, 781314, 6117540, 77915273, 749298455, 78696587, 755415995,22, 642412, 4804082, 82690520, 786870011, 83332932, 791674093
[3; 14; 7; 10; 6; 2; 12; 13; 4; 15; 8; 9; 1; 11; 16; 5], 18, 818144, 6512208, 78568745, 754588680, 79386889, 761100888,22, 642412, 4804082, 82690520, 786870011, 83332932, 791674093
[2; 12; 7; 8; 15; 13; 14; 3; 6; 1; 4; 5; 16; 10; 11; 9], 16, 722060, 5724004, 75654332, 723396479, 76376392, 729120483,22, 642412, 4804082, 82690520, 786870011, 83332932, 791674093
[4; 11; 12; 10; 13; 15; 7; 6; 5; 9; 2; 16; 3; 8; 14; 1], 18, 805653, 6152187, 77932082, 743736913, 78737735, 749889100,22, 642412, 4804082, 82690520, 786870011, 83332932, 791674093
[6; 8; 13; 12; 15; 1; 11; 5; 7; 9; 14; 10; 16; 4; 2; 3], 18, 713238, 5350372, 76522187, 731829924, 77235425, 737180296,22, 642412, 4804082, 82690520, 786870011, 83332932, 791674093
[2; 3; 4; 12; 15; 9; 6; 14; 11; 5; 1; 8; 7; 10; 13; 16], 16, 728656, 5492932, 78392901, 754508434, 79121557, 760001366,22, 642412, 4804082, 82690520, 786870011, 83332932, 791674093
[11; 7; 15; 10; 16; 5; 1; 14; 2; 3; 4; 6; 12; 13; 9; 8], 18, 777329, 5831523, 73952876, 709400375, 74730205, 715231898,22, 642412, 4804082, 82690520, 786870011, 83332932, 791674093
[1; 7; 10; 4; 5; 14; 11; 3; 12; 6; 9; 2; 8; 15; 13; 16], 18, 805788, 6037911, 77038376, 738358084, 77844164, 744395995,22, 642412, 4804082, 82690520, 786870011, 83332932, 791674093
[8; 6; 3; 14; 13; 10; 12; 5; 11; 4; 2; 9; 1; 15; 16; 7], 18, 734978, 5525359, 73890612, 707151864, 74625590, 712677223,22, 642412, 4804082, 82690520, 786870011, 83332932, 791674093
[9; 14; 16; 12; 3; 6; 7; 15; 4; 11; 2; 10; 13; 1; 8; 5], 16, 729750, 6139602, 74806374, 717237133, 75536124, 723376735,22, 642412, 4804082, 82690520, 786870011, 83332932, 791674093
[2; 15; 4; 10; 14; 5; 12; 6; 7; 11; 13; 16; 9; 1; 3; 8], 16, 785222, 5977208, 78534605, 755778821, 79319827, 761756029,22, 642412, 4804082, 82690520, 786870011, 83332932, 791674093
[13; 1; 15; 5; 2; 4; 11; 3; 14; 10; 9; 7; 6; 16; 12; 8], 16, 780074, 5867048, 77944193, 749571899, 78724267, 755438947,22, 642412, 4804082, 82690520, 786870011, 83332932, 791674093
[14; 2; 8; 5; 10; 11; 7; 3; 15; 13; 6; 16; 12; 9; 1; 4], 18, 785145, 6076248, 77921853, 745396088, 78706998, 751472336,22, 642412, 4804082, 82690520, 786870011, 83332932, 791674093
[14; 7; 8; 12; 1; 16; 5; 13; 15; 3; 4; 10; 11; 6; 9; 2], 18, 799197, 6440555, 77795698, 746676869, 78594895, 753117424,22, 642412, 4804082, 82690520, 786870011, 83332932, 791674093
[1; 13; 5; 8; 10; 3; 14; 15; 2; 12; 6; 7; 16; 9; 11; 4], 16, 807356, 6283522, 78411954, 752715900, 79219310, 758999422,22, 642412, 4804082, 82690520, 786870011, 83332932, 791674093
[1; 5; 15; 10; 12; 8; 11; 2; 13; 4; 14; 9; 3; 16; 7; 6], 16, 802010, 6253964, 74075437, 710711367, 74877447, 716965331,22, 642412, 4804082, 82690520, 786870011, 83332932, 791674093
[12; 1; 16; 7; 4; 9; 6; 2; 15; 14; 11; 3; 8; 5; 10; 13], 18, 723444, 5769426, 76207613, 730311814, 76931057, 736081240,22, 642412, 4804082, 82690520, 786870011, 83332932, 791674093
[7; 8; 16; 10; 6; 9; 1; 13; 2; 11; 14; 12; 3; 5; 15; 4], 18, 791706, 5944458, 73661978, 706020786, 74453684, 711965244,22, 642412, 4804082, 82690520, 786870011, 83332932, 791674093
[16; 7; 3; 6; 2; 13; 12; 9; 11; 1; 4; 15; 5; 8; 14; 10], 18, 688626, 5398006, 75822578, 725091917, 76511204, 730489923,22, 642412, 4804082, 82690520, 786870011, 83332932, 791674093
[11; 5; 13; 1; 12; 6; 8; 10; 14; 9; 3; 16; 4; 7; 2; 15], 16, 712766, 5510262, 74203692, 712109944, 74916458, 717620206,22, 642412, 4804082, 82690520, 786870011, 83332932, 791674093
[13; 10; 12; 8; 16; 1; 15; 4; 3; 2; 6; 14; 5; 9; 7; 11], 18, 817155, 6205471, 77019161, 736467663, 77836316, 742673134,22, 642412, 4804082, 82690520, 786870011, 83332932, 791674093
[8; 5; 3; 2; 6; 1; 16; 12; 4; 10; 15; 11; 9; 13; 14; 7], 18, 705713, 5509167, 75622075, 724020750, 76327788, 729529917,22, 642412, 4804082, 82690520, 786870011, 83332932, 791674093
[4; 13; 8; 16; 14; 7; 10; 5; 6; 2; 12; 11; 3; 9; 1; 15], 16, 800974, 6136826, 77140423, 741326228, 77941397, 747463054,22, 642412, 4804082, 82690520, 786870011, 83332932, 791674093
[11; 10; 8; 5; 6; 3; 12; 2; 1; 13; 7; 9; 4; 14; 15; 16], 18, 793904, 6076498, 77416281, 740787485, 78210185, 746863983,22, 642412, 4804082, 82690520, 786870011, 83332932, 791674093
[1; 3; 8; 4; 13; 10; 2; 14; 16; 7; 11; 12; 6; 9; 15; 5], 16, 802682, 6013050, 75591858, 725130723, 76394540, 731143773,22, 642412, 4804082, 82690520, 786870011, 83332932, 791674093
[9; 13; 3; 8; 7; 4; 15; 10; 2; 11; 16; 12; 6; 1; 14; 5], 18, 802787, 6498044, 75703936, 725386645, 76506723, 731884689,22, 642412, 4804082, 82690520, 786870011, 83332932, 791674093
[2; 1; 12; 3; 11; 8; 7; 14; 15; 10; 4; 6; 13; 9; 16; 5], 16, 756812, 6130352, 74953874, 717372877, 75710686, 723503229,22, 642412, 4804082, 82690520, 786870011, 83332932, 791674093
[9; 16; 12; 7; 1; 15; 6; 14; 4; 13; 2; 3; 8; 11; 10; 5], 16, 720274, 5407380, 74809765, 717233122, 75530039, 722640502,22, 642412, 4804082, 82690520, 786870011, 83332932, 791674093
[6; 2; 4; 15; 10; 5; 1; 9; 14; 7; 3; 11; 12; 13; 8; 16], 18, 724118, 5396580, 77256214, 739792732, 77980332, 745189312,22, 642412, 4804082, 82690520, 786870011, 83332932, 791674093
[8; 11; 15; 7; 6; 12; 4; 13; 10; 5; 16; 1; 2; 3; 9; 14], 16, 693126, 5173474, 74327904, 711878491, 75021030, 717051965,22, 642412, 4804082, 82690520, 786870011, 83332932, 791674093
[14; 2; 13; 12; 9; 3; 5; 8; 7; 16; 15; 6; 1; 11; 10; 4], 16, 711588, 5437162, 75122920, 719031591, 75834508, 724468753,22, 642412, 4804082, 82690520, 786870011, 83332932, 791674093
[7; 9; 3; 4; 14; 6; 15; 1; 2; 8; 5; 10; 12; 13; 16; 11], 18, 749418, 5626784, 75515546, 723046385, 76264964, 728673169,22, 642412, 4804082, 82690520, 786870011, 83332932, 791674093
[9; 7; 16; 11; 8; 10; 1; 5; 6; 12; 2; 14; 15; 4; 3; 13], 18, 772103, 6129464, 76329533, 731965899, 77101636, 738095363,22, 642412, 4804082, 82690520, 786870011, 83332932, 791674093
[11; 14; 6; 3; 8; 5; 1; 13; 4; 9; 2; 15; 10; 7; 16; 12], 16, 720596, 5383579, 75747558, 725917579, 76468154, 731301158,22, 642412, 4804082, 82690520, 786870011, 83332932, 791674093
[6; 4; 3; 1; 9; 15; 13; 10; 16; 11; 7; 5; 14; 2; 12; 8], 18, 743558, 5546186, 76675902, 733751088, 77419460, 739297274,22, 642412, 4804082, 82690520, 786870011, 83332932, 791674093
[16; 15; 14; 11; 6; 2; 10; 9; 3; 4; 13; 1; 8; 5; 12; 7], 16, 705250, 5296502, 77880209, 746994911, 78585459, 752291413,22, 642412, 4804082, 82690520, 786870011, 83332932, 791674093
[15; 16; 8; 14; 4; 3; 2; 12; 13; 6; 9; 11; 7; 10; 1; 5], 16, 724978, 5668066, 78163858, 750812364, 78888836, 756480430,22, 642412, 4804082, 82690520, 786870011, 83332932, 791674093
[3; 11; 8; 1; 2; 9; 13; 16; 4; 12; 10; 7; 6; 5; 15; 14], 16, 749556, 5983758, 76794474, 737902911, 77544030, 743886669,22, 642412, 4804082, 82690520, 786870011, 83332932, 791674093
[11; 9; 14; 6; 10; 3; 15; 13; 8; 16; 1; 12; 2; 5; 4; 7], 16, 726584, 5667180, 75439080, 722984425, 76165664, 728651605,22, 642412, 4804082, 82690520, 786870011, 83332932, 791674093
[2; 14; 7; 8; 1; 3; 16; 4; 5; 13; 9; 6; 10; 15; 11; 12], 18, 747568, 5707082, 76880431, 736307101, 77627999, 742014183,22, 642412, 4804082, 82690520, 786870011, 83332932, 791674093
[3; 4; 11; 7; 14; 12; 15; 6; 13; 5; 8; 9; 10; 2; 16; 1], 16, 758294, 5965406, 75830710, 726331010, 76589004, 732296416,22, 642412, 4804082, 82690520, 786870011, 83332932, 791674093
[4; 16; 15; 6; 12; 11; 2; 8; 9; 13; 14; 10; 5; 7; 3; 1], 18, 726152, 5470727, 76605117, 731884531, 77331269, 737355258,22, 642412, 4804082, 82690520, 786870011, 83332932, 791674093
[2; 10; 15; 11; 4; 6; 5; 9; 3; 12; 1; 13; 16; 7; 8; 14], 18, 796443, 6118519, 77114219, 737424126, 77910662, 743542645,22, 642412, 4804082, 82690520, 786870011, 83332932, 791674093
[14; 2; 7; 11; 13; 8; 9; 15; 4; 10; 1; 12; 16; 3; 5; 6], 18, 748230, 5882529, 75759948, 725734209, 76508178, 731616738,22, 642412, 4804082, 82690520, 786870011, 83332932, 791674093
[16; 3; 14; 6; 12; 15; 5; 11; 9; 8; 10; 2; 7; 1; 13; 4], 16, 720804, 5642326, 75639588, 723818356, 76360392, 729460682,22, 642412, 4804082, 82690520, 786870011, 83332932, 791674093
[16; 4; 7; 3; 10; 14; 12; 9; 6; 8; 5; 11; 13; 15; 2; 1], 18, 799207, 6029364, 74858675, 717942001, 75657882, 723971365,22, 642412, 4804082, 82690520, 786870011, 83332932, 791674093
[11; 7; 10; 6; 15; 13; 16; 3; 12; 8; 14; 2; 5; 9; 4; 1], 18, 782370, 6071406, 75025156, 718772177, 75807526, 724843583,22, 642412, 4804082, 82690520, 786870011, 83332932, 791674093
[3; 1; 16; 14; 12; 6; 5; 10; 2; 11; 7; 9; 8; 15; 13; 4], 16, 744126, 5624358, 77116575, 738614947, 77860701, 744239305,22, 642412, 4804082, 82690520, 786870011, 83332932, 791674093
[7; 15; 5; 8; 1; 16; 6; 13; 10; 9; 14; 3; 4; 11; 2; 12], 18, 705682, 5271448, 75391305, 721983959, 76096987, 727255407,22, 642412, 4804082, 82690520, 786870011, 83332932, 791674093
[16; 9; 4; 10; 12; 11; 1; 14; 15; 3; 5; 6; 8; 7; 13; 2], 16, 801166, 6191704, 74226537, 710472578, 75027703, 716664282,22, 642412, 4804082, 82690520, 786870011, 83332932, 791674093
[13; 12; 4; 11; 9; 16; 14; 3; 7; 10; 15; 8; 1; 5; 2; 6], 16, 800324, 6159154, 77067256, 738465133, 77867580, 744624287,22, 642412, 4804082, 82690520, 786870011, 83332932, 791674093
[1; 13; 8; 11; 6; 2; 12; 4; 15; 16; 10; 5; 7; 9; 14; 3], 16, 701696, 5492790, 75483278, 722757091, 76184974, 728249881,22, 642412, 4804082, 82690520, 786870011, 83332932, 791674093
[5; 4; 1; 7; 16; 13; 8; 15; 12; 10; 14; 11; 3; 6; 2; 9], 16, 798598, 6345494, 79143872, 759934415, 79942470, 766279909,22, 642412, 4804082, 82690520, 786870011, 83332932, 791674093
[8; 2; 7; 1; 9; 15; 10; 6; 13; 16; 11; 14; 5; 4; 3; 12], 18, 775318, 5878844, 75836791, 726750408, 76612109, 732629252,22, 642412, 4804082, 82690520, 786870011, 83332932, 791674093
[8; 1; 14; 11; 2; 7; 12; 9; 16; 5; 10; 13; 15; 6; 4; 3], 16, 752118, 5974340, 76276911, 730901959, 77029029, 736876299,22, 642412, 4804082, 82690520, 786870011, 83332932, 791674093
[3; 16; 2; 11; 1; 7; 9; 8; 6; 4; 12; 13; 15; 5; 14; 10], 16, 681874, 5184328, 74897245, 716622951, 75579119, 721807279,22, 642412, 4804082, 82690520, 786870011, 83332932, 791674093
[1; 4; 2; 12; 7; 8; 13; 15; 9; 6; 16; 10; 3; 5; 14; 11], 16, 723800, 5768262, 76979500, 739760897, 77703300, 745529159,22, 642412, 4804082, 82690520, 786870011, 83332932, 791674093
[9; 14; 8; 13; 16; 5; 11; 12; 10; 6; 7; 2; 4; 1; 3; 15], 16, 776114, 6129462, 76398212, 731965888, 77174326, 738095350,22, 642412, 4804082, 82690520, 786870011, 83332932, 791674093
[10; 12; 1; 16; 4; 15; 9; 13; 8; 11; 6; 14; 5; 3; 7; 2], 18, 818402, 6104016, 80693500, 770136993, 81511902, 776241009,22, 642412, 4804082, 82690520, 786870011, 83332932, 791674093
[12; 1; 13; 4; 2; 5; 9; 11; 10; 3; 15; 14; 8; 6; 16; 7], 16, 784140, 6117240, 77831082, 746776625, 78615222, 752893865,22, 642412, 4804082, 82690520, 786870011, 83332932, 791674093
[1; 5; 13; 3; 4; 2; 16; 8; 9; 7; 15; 11; 14; 12; 10; 6], 16, 778622, 6075576, 79168373, 761008160, 79946995, 767083736,22, 642412, 4804082, 82690520, 786870011, 83332932, 791674093
[11; 6; 3; 5; 15; 8; 1; 7; 16; 2; 9; 4; 10; 14; 12; 13], 18, 673506, 5046793, 76200532, 732082839, 76874038, 737129632,22, 642412, 4804082, 82690520, 786870011, 83332932, 791674093
[8; 3; 16; 11; 5; 13; 15; 1; 14; 7; 12; 10; 9; 4; 2; 6], 16, 758006, 6003784, 76727788, 734978688, 77485794, 740982472,22, 642412, 4804082, 82690520, 786870011, 83332932, 791674093
[5; 15; 8; 9; 1; 3; 16; 4; 11; 14; 12; 6; 7; 10; 2; 13], 16, 723034, 5536918, 76760558, 737442413, 77483592, 742979331,22, 642412, 4804082, 82690520, 786870011, 83332932, 791674093
[5; 2; 13; 3; 1; 8; 6; 10; 14; 11; 15; 7; 4; 9; 16; 12], 16, 709432, 5938887, 75232172, 720541663, 75941604, 726480550,22, 642412, 4804082, 82690520, 786870011, 83332932, 791674093
[14; 4; 3; 1; 15; 5; 11; 13; 7; 2; 16; 9; 10; 8; 12; 6], 16, 792768, 5924718, 75790026, 727129465, 76582794, 733054183,22, 642412, 4804082, 82690520, 786870011, 83332932, 791674093
[9; 14; 8; 6; 13; 16; 4; 3; 2; 7; 11; 12; 1; 10; 15; 5], 18, 736882, 5617732, 77239100, 740839683, 77975982, 746457415,22, 642412, 4804082, 82690520, 786870011, 83332932, 791674093
[16; 7; 12; 13; 6; 2; 11; 10; 15; 5; 3; 4; 14; 9; 8; 1], 18, 700636, 5325425, 76791968, 736380438, 77492604, 741705863,22, 642412, 4804082, 82690520, 786870011, 83332932, 791674093
[8; 12; 10; 1; 2; 5; 6; 7; 4; 15; 3; 9; 16; 13; 14; 11], 16, 809212, 6366914, 76427498, 733557885, 77236710, 739924799,22, 642412, 4804082, 82690520, 786870011, 83332932, 791674093
[5; 12; 10; 14; 15; 9; 2; 7; 4; 16; 1; 6; 11; 3; 8; 13], 16, 812800, 6083890, 75972385, 728251450, 76785185, 734335340,22, 642412, 4804082, 82690520, 786870011, 83332932, 791674093
[5; 2; 13; 14; 8; 9; 10; 11; 3; 7; 6; 12; 4; 16; 15; 1], 18, 785617, 6030694, 78695517, 754029671, 79481134, 760060365,22, 642412, 4804082, 82690520, 786870011, 83332932, 791674093
[5; 8; 4; 11; 12; 2; 16; 15; 3; 6; 14; 1; 10; 13; 9; 7], 16, 713122, 5351040, 75082622, 719224985, 75795744, 724576025,22, 642412, 4804082, 82690520, 786870011, 83332932, 791674093
[10; 9; 8; 3; 11; 5; 14; 4; 16; 12; 15; 7; 1; 13; 2; 6], 18, 818402, 6104016, 81240581, 775682144, 82058983, 781786160,22, 642412, 4804082, 82690520, 786870011, 83332932, 791674093
[11; 13; 3; 9; 12; 2; 7; 6; 16; 1; 10; 5; 14; 8; 4; 15], 16, 699004, 5330978, 75649601, 724556930, 76348605, 729887908,22, 642412, 4804082, 82690520, 786870011, 83332932, 791674093
[2; 6; 3; 16; 1; 7; 8; 4; 14; 10; 11; 9; 15; 12; 13; 5], 18, 699786, 5254571, 76062537, 728000755, 76762323, 733255326,22, 642412, 4804082, 82690520, 786870011, 83332932, 791674093
[9; 16; 3; 6; 12; 4; 13; 7; 14; 10; 1; 11; 5; 8; 15; 2], 16, 735738, 5788966, 75340103, 720931037, 76075841, 726720003,22, 642412, 4804082, 82690520, 786870011, 83332932, 791674093
[15; 6; 14; 7; 12; 1; 4; 2; 13; 5; 9; 8; 10; 3; 11; 16], 18, 721495, 5573839, 76089253, 727493323, 76810748, 733067162,22, 642412, 4804082, 82690520, 786870011, 83332932, 791674093
[14; 9; 6; 10; 15; 11; 8; 12; 2; 4; 5; 13; 3; 1; 16; 7], 18, 752097, 6103916, 74411417, 710620521, 75163514, 716724437,22, 642412, 4804082, 82690520, 786870011, 83332932, 791674093
[9; 4; 7; 10; 12; 3; 2; 8; 1; 11; 16; 6; 15; 14; 5; 13], 16, 807344, 6041174, 75213165, 720712481, 76020509, 726753655,22, 642412, 4804082, 82690520, 786870011, 83332932, 791674093
[12; 13; 3; 6; 4; 14; 9; 11; 10; 2; 1; 7; 8; 15; 16; 5], 16, 749494, 5729416, 77769925, 745172015, 78519419, 750901431,22, 642412, 4804082, 82690520, 786870011, 83332932, 791674093
[16; 2; 9; 1; 13; 15; 4; 10; 11; 6; 7; 8; 3; 12; 5; 14], 16, 770116, 5976718, 75822823, 727961376, 76592939, 733938094,22, 642412, 4804082, 82690520, 786870011, 83332932, 791674093
[14; 15; 9; 16; 6; 13; 10; 3; 4; 1; 12; 7; 2; 8; 5; 11], 16, 740164, 5554070, 74536985, 714253177, 75277149, 719807247,22, 642412, 4804082, 82690520, 786870011, 83332932, 791674093
[14; 8; 10; 3; 4; 15; 7; 9; 11; 6; 12; 1; 5; 2; 16; 13], 18, 814345, 6230200, 76517796, 732514438, 77332141, 738744638,22, 642412, 4804082, 82690520, 786870011, 83332932, 791674093
[3; 14; 11; 8; 5; 4; 16; 10; 6; 2; 7; 15; 1; 9; 12; 13], 16, 778346, 6473742, 76194389, 731186203, 76972735, 737659945,22, 642412, 4804082, 82690520, 786870011, 83332932, 791674093
[10; 3; 14; 4; 15; 7; 9; 16; 11; 5; 6; 8; 12; 2; 1; 13], 18, 818402, 6104016, 80291622, 766783142, 81110024, 772887158,22, 642412, 4804082, 82690520, 786870011, 83332932, 791674093
[9; 12; 15; 10; 5; 4; 1; 2; 7; 11; 14; 16; 3; 6; 8; 13], 16, 810814, 6394190, 75006326, 720285276, 75817140, 726679466,22, 642412, 4804082, 82690520, 786870011, 83332932, 791674093
[14; 6; 13; 15; 16; 4; 3; 9; 2; 7; 12; 5; 11; 1; 10; 8], 18, 737155, 5756368, 76244961, 729887661, 76982116, 735644029,22, 642412, 4804082, 82690520, 786870011, 83332932, 791674093
[11; 10; 14; 15; 6; 4; 16; 12; 7; 3; 13; 2; 8; 9; 1; 5], 18, 793807, 6054643, 76068216, 726944361, 76862023, 732999004,22, 642412, 4804082, 82690520, 786870011, 83332932, 791674093
[3; 6; 5; 10; 7; 9; 12; 16; 15; 1; 14; 8; 13; 2; 4; 11], 18, 745234, 5710098, 75437492, 721082688, 76182726, 726792786,22, 642412, 4804082, 82690520, 786870011, 83332932, 791674093
[8; 4; 13; 6; 11; 16; 7; 14; 15; 3; 5; 10; 2; 9; 1; 12], 16, 747218, 5601042, 75597089, 723763075, 76344307, 729364117,22, 642412, 4804082, 82690520, 786870011, 83332932, 791674093
[4; 11; 16; 15; 10; 5; 8; 13; 14; 6; 2; 9; 1; 12; 3; 7], 18, 800537, 6132758, 76966118, 735101128, 77766655, 741233886,22, 642412, 4804082, 82690520, 786870011, 83332932, 791674093
[2; 16; 7; 8; 14; 3; 10; 6; 5; 4; 9; 13; 1; 12; 11; 15], 16, 768488, 5770464, 78486911, 752764955, 79255399, 758535419,22, 642412, 4804082, 82690520, 786870011, 83332932, 791674093
[1; 15; 10; 12; 4; 11; 13; 5; 3; 2; 14; 6; 8; 9; 7; 16], 18, 805284, 6058465, 78721343, 752850338, 79526627, 758908803,22, 642412, 4804082, 82690520, 786870011, 83332932, 791674093
[5; 1; 15; 6; 11; 16; 14; 9; 2; 10; 7; 8; 13; 12; 3; 4], 16, 688994, 5411306, 76459674, 732069941, 77148668, 737481247,22, 642412, 4804082, 82690520, 786870011, 83332932, 791674093
[9; 15; 1; 11; 5; 14; 12; 16; 6; 13; 4; 8; 7; 3; 10; 2], 16, 710520, 5353948, 75155492, 720258162, 75866012, 725612110,22, 642412, 4804082, 82690520, 786870011, 83332932, 791674093
[9; 7; 10; 3; 2; 5; 15; 13; 6; 12; 14; 1; 8; 11; 4; 16], 18, 811233, 6431818, 76865154, 736030048, 77676387, 742461866,22, 642412, 4804082, 82690520, 786870011, 83332932, 791674093
[11; 14; 6; 1; 12; 9; 4; 3; 7; 16; 13; 15; 10; 8; 2; 5], 16, 726364, 5625778, 75720230, 724919270, 76446594, 730545048,22, 642412, 4804082, 82690520, 786870011, 83332932, 791674093
[2; 12; 14; 11; 10; 6; 1; 8; 4; 16; 15; 9; 3; 7; 5; 13], 16, 770834, 6167417, 77983289, 748990476, 78754123, 755157893,22, 642412, 4804082, 82690520, 786870011, 83332932, 791674093
[10; 2; 11; 1; 13; 12; 4; 6; 7; 16; 5; 14; 9; 15; 3; 8], 18, 818402, 6104016, 80647709, 769867806, 81466111, 775971822,22, 642412, 4804082, 82690520, 786870011, 83332932, 791674093
[9; 12; 15; 10; 16; 4; 3; 13; 6; 5; 2; 11; 1; 8; 7; 14], 16, 812326, 6401618, 75839138, 726827980, 76651464, 733229598,22, 642412, 4804082, 82690520, 786870011, 83332932, 791674093
[14; 2; 15; 13; 7; 16; 9; 4; 8; 6; 1; 12; 10; 11; 5; 3], 16, 737712, 6011182, 77999829, 748596117, 78737541, 754607299,22, 642412, 4804082, 82690520, 786870011, 83332932, 791674093
[14; 13; 8; 4; 1; 3; 7; 5; 6; 9; 11; 12; 10; 16; 15; 2], 16, 759688, 5763148, 76496233, 733686894, 77255921, 739450042,22, 642412, 4804082, 82690520, 786870011, 83332932, 791674093
[15; 2; 4; 3; 11; 6; 10; 5; 1; 13; 9; 8; 7; 12; 16; 14], 16, 723146, 5581355, 74364322, 712208522, 75087468, 717789877,22, 642412, 4804082, 82690520, 786870011, 83332932, 791674093
[14; 7; 3; 12; 5; 13; 16; 1; 15; 8; 6; 11; 2; 10; 4; 9], 18, 737742, 5733975, 76623864, 735329691, 77361606, 741063666,22, 642412, 4804082, 82690520, 786870011, 83332932, 791674093
[2; 14; 16; 12; 7; 4; 3; 5; 8; 10; 6; 9; 11; 15; 1; 13], 16, 777868, 6249048, 74362401, 713659557, 75140269, 719908605,22, 642412, 4804082, 82690520, 786870011, 83332932, 791674093
[5; 11; 3; 2; 12; 14; 7; 10; 6; 16; 4; 9; 15; 8; 1; 13], 16, 760368, 5961800, 76989558, 737931823, 77749926, 743893623,22, 642412, 4804082, 82690520, 786870011, 83332932, 791674093
[1; 11; 3; 15; 5; 2; 7; 9; 13; 12; 8; 14; 6; 10; 16; 4], 16, 692508, 5258951, 77056620, 737754982, 77749128, 743013933,22, 642412, 4804082, 82690520, 786870011, 83332932, 791674093
[4; 11; 13; 2; 16; 15; 12; 14; 7; 1; 5; 9; 6; 3; 8; 10], 16, 736852, 5661928, 75439031, 721729978, 76175883, 727391906,22, 642412, 4804082, 82690520, 786870011, 83332932, 791674093
[8; 14; 11; 4; 5; 1; 12; 7; 2; 13; 6; 16; 10; 9; 3; 15], 16, 716662, 5486080, 75801906, 725502068, 76518568, 730988148,22, 642412, 4804082, 82690520, 786870011, 83332932, 791674093
[5; 2; 15; 4; 12; 14; 3; 10; 9; 11; 1; 6; 8; 7; 13; 16], 16, 777074, 6121572, 77633639, 745177886, 78410713, 751299458,22, 642412, 4804082, 82690520, 786870011, 83332932, 791674093
[16; 1; 6; 5; 12; 10; 15; 4; 11; 7; 13; 14; 8; 2; 3; 9], 18, 727113, 5531129, 76220327, 730546702, 76947440, 736077831,22, 642412, 4804082, 82690520, 786870011, 83332932, 791674093
[5; 14; 1; 10; 9; 15; 16; 2; 7; 3; 6; 11; 4; 8; 12; 13], 16, 809670, 6471760, 75749266, 725931049, 76558936, 732402809,22, 642412, 4804082, 82690520, 786870011, 83332932, 791674093
[8; 12; 1; 4; 13; 7; 6; 16; 3; 5; 10; 11; 9; 15; 14; 2], 16, 746014, 5872538, 73935360, 707689941, 74681374, 713562479,22, 642412, 4804082, 82690520, 786870011, 83332932, 791674093
[11; 12; 15; 4; 16; 9; 14; 8; 2; 6; 1; 7; 5; 3; 13; 10], 16, 712822, 5796672, 76108604, 728748163, 76821426, 734544835,22, 642412, 4804082, 82690520, 786870011, 83332932, 791674093
[4; 14; 15; 7; 3; 8; 10; 9; 5; 12; 16; 1; 11; 13; 2; 6], 16, 807618, 6032368, 76228543, 731313586, 77036161, 737345954,22, 642412, 4804082, 82690520, 786870011, 83332932, 791674093
[5; 4; 9; 16; 12; 11; 7; 10; 6; 14; 13; 1; 2; 3; 15; 8], 16, 794444, 6134440, 75498186, 724315847, 76292630, 730450287,22, 642412, 4804082, 82690520, 786870011, 83332932, 791674093
[16; 7; 1; 11; 15; 8; 14; 12; 10; 6; 2; 9; 3; 13; 5; 4], 18, 760916, 5702499, 75511660, 722584484, 76272576, 728286983,22, 642412, 4804082, 82690520, 786870011, 83332932, 791674093
[16; 6; 13; 14; 7; 11; 8; 15; 3; 12; 9; 1; 10; 5; 2; 4], 18, 704694, 5230505, 75782041, 725925962, 76486735, 731156467,22, 642412, 4804082, 82690520, 786870011, 83332932, 791674093
[15; 2; 4; 9; 7; 6; 8; 16; 3; 5; 1; 12; 14; 11; 10; 13], 16, 712948, 5484438, 76796314, 736747648, 77509262, 742232086,22, 642412, 4804082, 82690520, 786870011, 83332932, 791674093
[11; 6; 9; 12; 3; 4; 2; 15; 13; 10; 5; 14; 7; 8; 1; 16], 18, 701318, 5251569, 77721106, 744948363, 78422424, 750199932,22, 642412, 4804082, 82690520, 786870011, 83332932, 791674093
[10; 4; 9; 6; 2; 5; 16; 13; 3; 7; 15; 14; 1; 8; 12; 11], 18, 818402, 6104016, 81167860, 774294107, 81986262, 780398123,22, 642412, 4804082, 82690520, 786870011, 83332932, 791674093
[11; 6; 3; 5; 8; 4; 14; 1; 7; 10; 15; 12; 16; 9; 2; 13], 18, 708943, 5478683, 75873052, 726031892, 76581995, 731510575,22, 642412, 4804082, 82690520, 786870011, 83332932, 791674093
[14; 16; 10; 1; 9; 2; 15; 4; 6; 8; 5; 12; 7; 11; 3; 13], 16, 807108, 6447410, 77506841, 744387221, 78313949, 750834631,22, 642412, 4804082, 82690520, 786870011, 83332932, 791674093
[11; 6; 7; 2; 15; 9; 8; 16; 1; 12; 3; 14; 5; 4; 10; 13], 18, 661282, 5011633, 75541157, 723438473, 76202439, 728450106,22, 642412, 4804082, 82690520, 786870011, 83332932, 791674093
[13; 1; 9; 2; 3; 6; 5; 10; 16; 7; 8; 11; 15; 4; 14; 12], 16, 725622, 5504932, 75774590, 725519110, 76500212, 731024042,22, 642412, 4804082, 82690520, 786870011, 83332932, 791674093
[10; 2; 7; 8; 15; 14; 3; 12; 9; 1; 4; 16; 5; 6; 11; 13], 18, 818402, 6104016, 80647000, 769779492, 81465402, 775883508,22, 642412, 4804082, 82690520, 786870011, 83332932, 791674093
[1; 11; 5; 12; 4; 14; 10; 6; 7; 9; 3; 13; 8; 15; 2; 16], 16, 777664, 6025334, 77572418, 745180236, 78350082, 751205570,22, 642412, 4804082, 82690520, 786870011, 83332932, 791674093
[11; 10; 9; 4; 7; 13; 3; 14; 5; 15; 1; 12; 6; 2; 8; 16], 18, 792581, 5988026, 76827200, 734162963, 77619781, 740150989,22, 642412, 4804082, 82690520, 786870011, 83332932, 791674093
[3; 10; 15; 7; 9; 16; 2; 5; 8; 11; 14; 1; 4; 13; 6; 12], 18, 817883, 6273975, 77260541, 739476038, 78078424, 745750013,22, 642412, 4804082, 82690520, 786870011, 83332932, 791674093
[16; 12; 11; 8; 9; 15; 7; 4; 3; 2; 14; 13; 10; 6; 5; 1], 16, 750654, 5911599, 77048015, 739051722, 77798669, 744963321,22, 642412, 4804082, 82690520, 786870011, 83332932, 791674093
[3; 16; 12; 2; 4; 15; 10; 8; 11; 6; 13; 5; 9; 14; 7; 1], 16, 782088, 6528796, 76229526, 731134576, 77011614, 737663372,22, 642412, 4804082, 82690520, 786870011, 83332932, 791674093
[8; 11; 3; 15; 9; 14; 6; 2; 10; 12; 7; 16; 4; 13; 1; 5], 16, 703520, 5570819, 76489577, 731614126, 77193097, 737184945,22, 642412, 4804082, 82690520, 786870011, 83332932, 791674093
[2; 9; 8; 3; 6; 13; 7; 11; 15; 4; 1; 5; 12; 14; 16; 10], 18, 686308, 5181434, 76371527, 731952930, 77057835, 737134364,22, 642412, 4804082, 82690520, 786870011, 83332932, 791674093
[14; 4; 1; 11; 9; 15; 10; 5; 8; 2; 12; 7; 3; 16; 13; 6], 16, 802996, 5986880, 76669569, 734541054, 77472565, 740527934,22, 642412, 4804082, 82690520, 786870011, 83332932, 791674093
[4; 16; 7; 13; 3; 14; 2; 12; 5; 15; 8; 6; 1; 10; 11; 9], 18, 753499, 5711247, 76047904, 727449441, 76801403, 733160688,22, 642412, 4804082, 82690520, 786870011, 83332932, 791674093
[5; 9; 2; 11; 13; 10; 8; 16; 7; 6; 12; 14; 15; 3; 1; 4], 16, 762786, 5900716, 76436695, 732181824, 77199481, 738082540,22, 642412, 4804082, 82690520, 786870011, 83332932, 791674093
[14; 11; 4; 2; 3; 10; 1; 7; 5; 12; 9; 6; 8; 16; 13; 15], 16, 772402, 6172915, 76792648, 737132199, 77565050, 743305114,22, 642412, 4804082, 82690520, 786870011, 83332932, 791674093
[4; 16; 3; 1; 2; 12; 11; 13; 5; 6; 8; 7; 10; 15; 9; 14], 16, 721966, 5521410, 75484202, 723305317, 76206168, 728826727,22, 642412, 4804082, 82690520, 786870011, 83332932, 791674093
[12; 2; 14; 15; 16; 9; 3; 1; 11; 4; 13; 5; 8; 6; 10; 7], 16, 702570, 5630176, 78562657, 752817580, 79265227, 758447756,22, 642412, 4804082, 82690520, 786870011, 83332932, 791674093
[13; 6; 15; 14; 9; 2; 16; 1; 7; 4; 8; 5; 10; 3; 11; 12], 18, 722803, 6027306, 77130673, 738537394, 77853476, 744564700,22, 642412, 4804082, 82690520, 786870011, 83332932, 791674093
[7; 13; 1; 16; 5; 15; 2; 12; 8; 14; 10; 6; 9; 4; 11; 3], 18, 777174, 5893320, 77961186, 747319420, 78738360, 753212740,22, 642412, 4804082, 82690520, 786870011, 83332932, 791674093
[8; 11; 2; 14; 1; 7; 6; 16; 3; 9; 15; 4; 5; 12; 10; 13], 16, 676042, 5062252, 77712536, 745880524, 78388578, 750942776,22, 642412, 4804082, 82690520, 786870011, 83332932, 791674093
[1; 11; 15; 7; 8; 3; 6; 2; 12; 14; 9; 13; 10; 5; 4; 16], 18, 680005, 5079427, 76476077, 733268400, 77156082, 738347827,22, 642412, 4804082, 82690520, 786870011, 83332932, 791674093
[2; 16; 7; 13; 6; 8; 14; 12; 1; 4; 10; 9; 15; 5; 11; 3], 16, 700676, 5487902, 76009704, 728343207, 76710380, 733831109,22, 642412, 4804082, 82690520, 786870011, 83332932, 791674093
[13; 4; 11; 16; 8; 6; 1; 2; 3; 14; 7; 12; 10; 9; 15; 5], 16, 728698, 5714686, 77053040, 737094573, 77781738, 742809259,22, 642412, 4804082, 82690520, 786870011, 83332932, 791674093
[15; 13; 12; 7; 6; 10; 9; 14; 3; 1; 2; 16; 5; 11; 4; 8], 16, 741826, 5874942, 74468018, 712777883, 75209844, 718652825,22, 642412, 4804082, 82690520, 786870011, 83332932, 791674093
[15; 6; 2; 14; 7; 1; 16; 9; 3; 10; 4; 5; 12; 13; 8; 11], 18, 701491, 5427891, 75938930, 726223296, 76640421, 731651187,22, 642412, 4804082, 82690520, 786870011, 83332932, 791674093
[7; 1; 16; 11; 8; 4; 14; 5; 6; 2; 13; 3; 9; 15; 12; 10], 18, 710254, 5390888, 75267604, 720224245, 75977858, 725615133,22, 642412, 4804082, 82690520, 786870011, 83332932, 791674093
[11; 10; 7; 12; 4; 16; 6; 2; 13; 5; 15; 9; 3; 14; 1; 8], 18, 795544, 6144259, 76868271, 733655430, 77663815, 739799689,22, 642412, 4804082, 82690520, 786870011, 83332932, 791674093
[15; 6; 9; 11; 10; 2; 13; 3; 1; 14; 5; 4; 8; 16; 12; 7], 18, 713511, 5518289, 74467292, 711911757, 75180803, 717430046,22, 642412, 4804082, 82690520, 786870011, 83332932, 791674093
[10; 16; 6; 4; 14; 7; 12; 2; 8; 3; 13; 11; 15; 1; 9; 5], 18, 818402, 6104016, 80567258, 769196543, 81385660, 775300559,22, 642412, 4804082, 82690520, 786870011, 83332932, 791674093
[5; 15; 16; 8; 13; 14; 7; 4; 2; 10; 11; 6; 3; 1; 9; 12], 16, 774504, 6111136, 76111065, 729456789, 76885569, 735567925,22, 642412, 4804082, 82690520, 786870011, 83332932, 791674093
[13; 5; 8; 6; 9; 7; 1; 12; 3; 2; 16; 4; 10; 14; 11; 15], 18, 714355, 5579101, 77158784, 738009200, 77873139, 743588301,22, 642412, 4804082, 82690520, 786870011, 83332932, 791674093
[8; 6; 16; 1; 4; 5; 15; 3; 14; 9; 12; 11; 2; 10; 13; 7], 18, 712903, 5558400, 75816000, 726322033, 76528903, 731880433,22, 642412, 4804082, 82690520, 786870011, 83332932, 791674093
[15; 1; 8; 10; 2; 4; 5; 6; 16; 11; 9; 14; 13; 7; 3; 12], 16, 801862, 6008566, 77138334, 739606850, 77940196, 745615416,22, 642412, 4804082, 82690520, 786870011, 83332932, 791674093
[11; 7; 12; 10; 3; 8; 16; 2; 5; 15; 13; 4; 1; 14; 9; 6], 18, 782370, 6071406, 76398085, 731203907, 77180455, 737275313,22, 642412, 4804082, 82690520, 786870011, 83332932, 791674093
[8; 11; 6; 14; 7; 13; 15; 1; 5; 12; 2; 3; 4; 9; 10; 16], 16, 690412, 5394444, 76122101, 729552889, 76812513, 734947333,22, 642412, 4804082, 82690520, 786870011, 83332932, 791674093
[9; 15; 2; 3; 12; 4; 13; 14; 6; 5; 10; 7; 1; 11; 8; 16], 16, 732104, 5496156, 75260660, 719847055, 75992764, 725343211,22, 642412, 4804082, 82690520, 786870011, 83332932, 791674093
[10; 16; 15; 13; 3; 2; 1; 4; 5; 6; 11; 14; 8; 7; 9; 12], 18, 818402, 6104016, 81094940, 773869722, 81913342, 779973738,22, 642412, 4804082, 82690520, 786870011, 83332932, 791674093
[9; 3; 13; 15; 2; 7; 10; 5; 8; 1; 6; 11; 14; 4; 12; 16], 16, 780868, 6136857, 76113976, 729409290, 76894844, 735546147,22, 642412, 4804082, 82690520, 786870011, 83332932, 791674093
[12; 10; 15; 6; 9; 8; 4; 13; 1; 2; 3; 7; 11; 5; 16; 14], 18, 822483, 6343556, 77679825, 742962189, 78502308, 749305745,22, 642412, 4804082, 82690520, 786870011, 83332932, 791674093
[7; 13; 10; 16; 15; 6; 2; 5; 11; 1; 14; 8; 9; 3; 12; 4], 18, 807930, 6041668, 75406931, 722050653, 76214861, 728092321,22, 642412, 4804082, 82690520, 786870011, 83332932, 791674093
[1; 11; 3; 9; 14; 5; 8; 12; 16; 6; 15; 7; 10; 2; 13; 4], 16, 709214, 5309916, 76914792, 738648834, 77624006, 743958750,22, 642412, 4804082, 82690520, 786870011, 83332932, 791674093
[6; 7; 9; 3; 10; 11; 1; 4; 16; 5; 12; 2; 15; 14; 8; 13], 18, 731526, 5441550, 76706537, 733451835, 77438063, 738893385,22, 642412, 4804082, 82690520, 786870011, 83332932, 791674093
[9; 10; 12; 13; 5; 14; 3; 8; 1; 2; 6; 16; 4; 11; 7; 15], 18, 816563, 6448694, 76279969, 730676726, 77096532, 737125420,22, 642412, 4804082, 82690520, 786870011, 83332932, 791674093
[16; 2; 4; 14; 11; 12; 5; 15; 9; 7; 6; 10; 13; 1; 3; 8], 16, 719774, 5424280, 74518291, 713086840, 75238065, 718511120,22, 642412, 4804082, 82690520, 786870011, 83332932, 791674093
